#
# オーナメント登録
#
# オーナメント名	ロストする発見物名	ロストする発見物名	…
#

イシス像	イシス像
クフ王の象牙の像	クフ王の象牙の像
オシリス像	オシリス像
ホルス像	ホルス像
サラスバティー像	サラスバティー像
インドラ像	インドラ像
ヴィシュヌ像	ヴィシュヌ像
スーリヤ像	スーリヤ像
パチャママ像	パチャママ像
ウンクルンクル像	ウンクルンクル像
オニャンコポン像	オニャンコポン像
ンゲウォ像	ンゲウォ像
アンマ像	アンマ像
ロケシュヴァラ像	ロケシュヴァラ像
アポロン像	アポロン像
ゼウス像	ゼウス像
ポセイドン像	ポセイドン像
アフロディテ像	アフロディテ像
アルテミス像	アルテミス像
象牙の女神像	象牙の女神像
ケツアルコアトル像	ケツアルコアトル像
シペ・トテック像	シペ・トテック像
バステト像	バステト像
ハヌマーン像	ハヌマーン像
ダヴィデ	ダヴィデ
天馬とメルクリウス	天馬にまたがるメルクリウス
天馬にまたがる名声の女神	天馬にまたがる名声の女神
瀕死のガリア人	瀕死のガリア人
ラオコーン	ラオコーン
チャックモール	チャックモール
サモトラケのニケ	サモトラケのニケ
ミロのヴィーナス	ミロのヴィーナス
ピエタ	ピエタ
有翼人面獣身像	有翼人面獣身像
金とラピスラズリの牡山羊	金とラピスラズリの牡山羊
ウル	ウル
ギザのピラミッド	ギザのピラミッド
アブ・シンベル神殿	アブ・シンベル神殿
カルナック・ルクソール	カルナック・ルクソール神殿
コナーラク太陽神寺院	コナーラク太陽神寺院
ストーンヘンジ	ストーンヘンジ
ブリハディーシュヴァラ	ブリハディーシュヴァラ寺院
テノチティトラン	テノチティトラン
ホツ・マツア王のモアイ	ホツ・マツア王のモアイ
ギザのスフィンクス	ギザのスフィンクス
円盤投げ	円盤投げ
マグダラのマリア	マグダラのマリア
牛頭のある女王のリラ	牛頭のある女王のリラ
オルメカの巨大頭像	オルメカの巨大頭像
精霊の像	精霊の像
クノッソス宮殿	クノッソス宮殿
ペルセポリス遺跡	ペルセポリス遺跡
パレンケ	パレンケ
カッパドキア	カッパドキア
アンコール遺跡	アンコール遺跡
パガン遺跡	パガン遺跡
ウルル	ウルル
ロゼッタストーン	ロゼッタストーン
オリンピアのヘルメス像	オリンピアのヘルメス像
パルテノンのアテナ像	パルテノンのアテナ像
トルテカの戦士像	トルテカの戦士像
ヘビの彫像	蛇の彫像
ナーガ上の仏陀	ナーガ上の仏陀
イコン	イコン
岩窟の聖母	岩窟の聖母
キリスト降架	キリスト降架
キリスト昇架	キリスト昇架
最後の審判	最後の審判
最後の晩餐	最後の晩餐
受胎告知	受胎告知
バベルの塔	バベルの塔
バベルの塔（小）	バベルの塔（小）
モナリザ	モナリザ
レースを編む女	レースを編む女
ヴィーナスの誕生	ヴィーナスの誕生
ヴェールの女	ヴェールの女
果物かご	果物かご
聖母子と聖ヨハネ	聖母子と聖ヨハネ
聖母子と幼児ヨハネ	聖母子と幼児ヨハネ
聖母被昇天	聖母被昇天
洗礼者ヨハネ	洗礼者ヨハネ
ヒワの聖母	ヒワの聖母
プリマヴェーラ	プリマヴェーラ
マギの礼拝	マギの礼拝
ろうそくに火を灯す少年	ろうそくに火を灯す少年
怠け者の天国	怠け者の天国
ウルビーノのビーナス	ウルビーノのビーナス
眠れるビーナス	眠れるビーナス
聖ウェロニカ	聖ウェロニカ
デルフトの小道	デルフトの小道
ウィトルウィウス的人体図	ウィトルウィウス的人体図
キリストの洗礼	キリストの洗礼
ネーデルラントの諺	ネーデルラントの諺
聖ドニの殉教	聖ドニの殉教
トレドの風景	トレドの風景
メランコリア	メランコリア
花輪の聖母	花輪の聖母
リュートを弾く道化師	リュートを弾く道化師
安土城	安土城
狛犬	狛犬
富士山	富士山
トルハルバン	トルハルバン
老君岩	老君岩
コロッセウム	コロッセウム
バトゥの財宝	バトゥの財宝
バトゥの財宝卓付	バトゥの財宝	大理石のテーブル
白銀の燭台	白銀の燭台
白銀の燭台卓付	白銀の燭台	大理石のテーブル
アトランティスの財宝	アトランティスの財宝
アトランティスの財宝卓付	アトランティスの財宝	大理石のテーブル
ソクラテスの盃	ソクラテスの盃
ソクラテスの盃卓付	ソクラテスの盃	大理石のテーブル
アルペの聖体器	アルペの聖体器
アルペの聖体器卓付	アルペの聖体器	大理石のテーブル
ドラゴンの牙	ドラゴンの牙
ドラゴンの牙卓付	ドラゴンの牙	大理石のテーブル
香炉	香炉
香炉卓付	香炉	大理石のテーブル
船形器	船形器
船形器卓付	船形器	大理石のテーブル
タコの絵のアムフォラ	タコの絵のアムフォラ
タコの絵のアムフォラ卓付	タコの絵のアムフォラ	大理石のテーブル
黄金の円盤	黄金の円盤
黄金の円盤卓付	黄金の円盤	大理石のテーブル
金の腕	金の腕
金の腕卓付	金の腕	大理石のテーブル
黄金の筏	黄金の筏
黄金の筏卓付	黄金の筏	大理石のテーブル
サリエラ	サリエラ
サリエラ卓付	サリエラ	大理石のテーブル
埴輪	埴輪
高麗青磁	高麗青磁
石獣	石獣
中壇元帥の銅像	中壇元帥の銅像
媽祖像	媽祖像
爵	爵
渾天儀	渾天儀
砂漠のバラ	砂漠のバラ
象嵌青銅器	象嵌青銅器
カーネーション	カーネーション
カーネーション卓付	カーネーション	大理石のテーブル
カーネーション花瓶付	カーネーション	アラバスターの花瓶
カーネーション花瓶卓付	カーネーション	アラバスターの花瓶	大理石のテーブル
カーネーションつぼ付	カーネーション	ペルシャ風のつぼ
カーネーションつぼ卓付	カーネーション	ペルシャ風のつぼ	大理石のテーブル
カーネーション白つぼ付	カーネーション	浮き彫りのつぼ
カーネーション白つぼ卓付	カーネーション	浮き彫りのつぼ	大理石のテーブル
アイリス	アイリス
アイリス卓付	アイリス	大理石のテーブル
アイリス花瓶付	アイリス	アラバスターの花瓶
アイリス花瓶卓付	アイリス	アラバスターの花瓶	大理石のテーブル
アイリスつぼ付	アイリス	ペルシャ風のつぼ
アイリスつぼ卓付	アイリス	ペルシャ風のつぼ	大理石のテーブル
アイリス白つぼ付	アイリス	浮き彫りのつぼ
アイリス白つぼ卓付	アイリス	浮き彫りのつぼ	大理石のテーブル
スイセン	スイセン
スイセン卓付	スイセン	大理石のテーブル
スイセン花瓶付	スイセン	アラバスターの花瓶
スイセン花瓶卓付	スイセン	アラバスターの花瓶	大理石のテーブル
スイセンつぼ付	スイセン	ペルシャ風のつぼ
スイセンつぼ卓付	スイセン	ペルシャ風のつぼ	大理石のテーブル
スイセン白つぼ付	スイセン	浮き彫りのつぼ
スイセン白つぼ卓付	スイセン	浮き彫りのつぼ	大理石のテーブル
コチョウラン	コチョウラン
コチョウラン卓付	コチョウラン	大理石のテーブル
コチョウラン花瓶付	コチョウラン	アラバスターの花瓶
コチョウラン花瓶卓付	コチョウラン	アラバスターの花瓶	大理石のテーブル
コチョウランつぼ付	コチョウラン	ペルシャ風のつぼ
コチョウランつぼ卓付	コチョウラン	ペルシャ風のつぼ	大理石のテーブル
コチョウラン白つぼ付	コチョウラン	浮き彫りのつぼ
コチョウラン白つぼ卓付	コチョウラン	浮き彫りのつぼ	大理石のテーブル
ポインセチア	ポインセチア
ポインセチア卓付	ポインセチア	大理石のテーブル
ポインセチア花瓶付	ポインセチア	アラバスターの花瓶
ポインセチア花瓶卓付	ポインセチア	アラバスターの花瓶	大理石のテーブル
ポインセチアつぼ付	ポインセチア	ペルシャ風のつぼ
ポインセチアつぼ卓付	ポインセチア	ペルシャ風のつぼ	大理石のテーブル
ポインセチア白つぼ付	ポインセチア	浮き彫りのつぼ
ポインセチア白つぼ卓付	ポインセチア	浮き彫りのつぼ	大理石のテーブル
マリーゴールド	マリーゴールド
マリーゴールド卓付	マリーゴールド	大理石のテーブル
マリーゴールド花瓶付	マリーゴールド	アラバスターの花瓶
マリーゴールド花瓶卓付	マリーゴールド	アラバスターの花瓶	大理石のテーブル
マリーゴールドつぼ付	マリーゴールド	ペルシャ風のつぼ
マリーゴールドつぼ卓付	マリーゴールド	ペルシャ風のつぼ	大理石のテーブル
マリーゴールド白つぼ付	マリーゴールド	浮き彫りのつぼ
マリーゴールド白つぼ卓付	マリーゴールド	浮き彫りのつぼ	大理石のテーブル
ダリア	ダリア
ダリア卓付	ダリア	大理石のテーブル
ダリア花瓶付	ダリア	アラバスターの花瓶
ダリア花瓶卓付	ダリア	アラバスターの花瓶	大理石のテーブル
ダリアつぼ付	ダリア	ペルシャ風のつぼ
ダリアつぼ卓付	ダリア	ペルシャ風のつぼ	大理石のテーブル
ダリア白つぼ付	ダリア	浮き彫りのつぼ
ダリア白つぼ卓付	ダリア	浮き彫りのつぼ	大理石のテーブル
シンビジューム	シンビジューム
シンビジューム卓付	シンビジューム	大理石のテーブル
シンビジューム花瓶付	シンビジューム	アラバスターの花瓶
シンビジューム花瓶卓付	シンビジューム	アラバスターの花瓶	大理石のテーブル
シンビジュームつぼ付	シンビジューム	ペルシャ風のつぼ
シンビジュームつぼ卓付	シンビジューム	ペルシャ風のつぼ	大理石のテーブル
シンビジューム白つぼ付	シンビジューム	浮き彫りのつぼ
シンビジューム白つぼ卓付	シンビジューム	浮き彫りのつぼ	大理石のテーブル
オーキッド	ブルー・オーキッド
オーキッド卓付	ブルー・オーキッド	大理石のテーブル
オーキッド花瓶付	ブルー・オーキッド	アラバスターの花瓶
オーキッド花瓶卓付	ブルー・オーキッド	アラバスターの花瓶	大理石のテーブル
オーキッドつぼ付	ブルー・オーキッド	ペルシャ風のつぼ
オーキッドつぼ卓付	ブルー・オーキッド	ペルシャ風のつぼ	大理石のテーブル
オーキッド白つぼ付	ブルー・オーキッド	浮き彫りのつぼ
オーキッド白つぼ卓付	ブルー・オーキッド	浮き彫りのつぼ	大理石のテーブル
シクラメン	シクラメン
シクラメン卓付	シクラメン	大理石のテーブル
シクラメン花瓶付	シクラメン	アラバスターの花瓶
シクラメン花瓶卓付	シクラメン	アラバスターの花瓶	大理石のテーブル
シクラメンつぼ付	シクラメン	ペルシャ風のつぼ
シクラメンつぼ卓付	シクラメン	ペルシャ風のつぼ	大理石のテーブル
シクラメン白つぼ付	シクラメン	浮き彫りのつぼ
シクラメン白つぼ卓付	シクラメン	浮き彫りのつぼ	大理石のテーブル
チューリップ	チューリップ
チューリップ卓付	チューリップ	大理石のテーブル
チューリップ花瓶付	チューリップ	アラバスターの花瓶
チューリップ花瓶卓付	チューリップ	アラバスターの花瓶	大理石のテーブル
チューリップつぼ付	チューリップ	ペルシャ風のつぼ
チューリップつぼ卓付	チューリップ	ペルシャ風のつぼ	大理石のテーブル
チューリップ白つぼ付	チューリップ	浮き彫りのつぼ
チューリップ白つぼ卓付	チューリップ	浮き彫りのつぼ	大理石のテーブル
アルストロメリア	アルストロメリア
アルストロメリア卓付	アルストロメリア	大理石のテーブル
アルストロメリア花瓶付	アルストロメリア	アラバスターの花瓶
アルストロメリア花瓶卓付	アルストロメリア	アラバスターの花瓶	大理石のテーブル
アルストロメリアつぼ付	アルストロメリア	ペルシャ風のつぼ
アルストロメリアつぼ卓付	アルストロメリア	ペルシャ風のつぼ	大理石のテーブル
アルストロメリア白つぼ付	アルストロメリア	浮き彫りのつぼ
アルストロメリア白つぼ卓	アルストロメリア	浮き彫りのつぼ	大理石のテーブル
カルセオラリア	カルセオラリア
カルセオラリア卓付	カルセオラリア	大理石のテーブル
カルセオラリア花瓶付	カルセオラリア	アラバスターの花瓶
カルセオラリア花瓶卓付	カルセオラリア	アラバスターの花瓶	大理石のテーブル
カルセオラリアつぼ付	カルセオラリア	ペルシャ風のつぼ
カルセオラリアつぼ卓付	カルセオラリア	ペルシャ風のつぼ	大理石のテーブル
カルセオラリア白つぼ付	カルセオラリア	浮き彫りのつぼ
カルセオラリア白つぼ卓付	カルセオラリア	浮き彫りのつぼ	大理石のテーブル
カトレア	カトレア
カトレア卓付	カトレア	大理石のテーブル
カトレア花瓶付	カトレア	アラバスターの花瓶
カトレア花瓶卓付	カトレア	アラバスターの花瓶	大理石のテーブル
カトレアつぼ付	カトレア	ペルシャ風のつぼ
カトレアつぼ卓付	カトレア	ペルシャ風のつぼ	大理石のテーブル
カトレア白つぼ付	カトレア	浮き彫りのつぼ
カトレア白つぼ卓付	カトレア	浮き彫りのつぼ	大理石のテーブル
エリデス	エリデス
エリデス卓付	エリデス	大理石のテーブル
エリデス花瓶付	エリデス	アラバスターの花瓶
エリデス花瓶卓付	エリデス	アラバスターの花瓶	大理石のテーブル
エリデスつぼ付	エリデス	ペルシャ風のつぼ
エリデスつぼ卓付	エリデス	ペルシャ風のつぼ	大理石のテーブル
エリデス白つぼ付	エリデス	浮き彫りのつぼ
エリデス白つぼ卓付	エリデス	浮き彫りのつぼ	大理石のテーブル
ファイアーバード	ファイアーバード
ファイアーバード卓付	ファイアーバード	大理石のテーブル
ファイアーバード花瓶付	ファイアーバード	アラバスターの花瓶
ファイアーバード花瓶卓付	ファイアーバード	アラバスターの花瓶	大理石のテーブル
ファイアーバードつぼ付	ファイアーバード	ペルシャ風のつぼ
ファイアーバードつぼ卓付	ファイアーバード	ペルシャ風のつぼ	大理石のテーブル
ファイアーバード白つぼ付	ファイアーバード	浮き彫りのつぼ
ファイアーバード白つぼ卓	ファイアーバード	浮き彫りのつぼ	大理石のテーブル
エーデルワイス	エーデルワイス
エーデルワイス卓付	エーデルワイス	大理石のテーブル
エーデルワイス花瓶付	エーデルワイス	アラバスターの花瓶
エーデルワイス花瓶卓付	エーデルワイス	アラバスターの花瓶	大理石のテーブル
エーデルワイスつぼ付	エーデルワイス	ペルシャ風のつぼ
エーデルワイスつぼ卓付	エーデルワイス	ペルシャ風のつぼ	大理石のテーブル
エーデルワイス白つぼ付	エーデルワイス	浮き彫りのつぼ
エーデルワイス白つぼ卓付	エーデルワイス	浮き彫りのつぼ	大理石のテーブル
カスミソウ	カスミソウ
カスミソウ卓付	カスミソウ	大理石のテーブル
カスミソウ花瓶付	カスミソウ	アラバスターの花瓶
カスミソウ花瓶卓付	カスミソウ	アラバスターの花瓶	大理石のテーブル
カスミソウつぼ付	カスミソウ	ペルシャ風のつぼ
カスミソウつぼ卓付	カスミソウ	ペルシャ風のつぼ	大理石のテーブル
カスミソウ白つぼ付	カスミソウ	浮き彫りのつぼ
カスミソウ白つぼ卓付	カスミソウ	浮き彫りのつぼ	大理石のテーブル
クンシラン	クンシラン
クンシラン卓付	クンシラン	大理石のテーブル
クンシラン花瓶付	クンシラン	アラバスターの花瓶
クンシラン花瓶卓付	クンシラン	アラバスターの花瓶	大理石のテーブル
クンシランつぼ付	クンシラン	ペルシャ風のつぼ
クンシランつぼ卓付	クンシラン	ペルシャ風のつぼ	大理石のテーブル
クンシラン白つぼ付	クンシラン	浮き彫りのつぼ
クンシラン白つぼ卓付	クンシラン	浮き彫りのつぼ	大理石のテーブル
スノードロップ	スノードロップ
スノードロップ卓付	スノードロップ	大理石のテーブル
スノードロップ花瓶付	スノードロップ	アラバスターの花瓶
スノードロップ花瓶卓付	スノードロップ	アラバスターの花瓶	大理石のテーブル
スノードロップつぼ付	スノードロップ	ペルシャ風のつぼ
スノードロップつぼ卓付	スノードロップ	ペルシャ風のつぼ	大理石のテーブル
スノードロップ白つぼ付	スノードロップ	浮き彫りのつぼ
スノードロップ白つぼ卓付	スノードロップ	浮き彫りのつぼ	大理石のテーブル
ヤグルマキク	ヤグルマキク
ヤグルマキク卓付	ヤグルマキク	大理石のテーブル
ヤグルマキク花瓶付	ヤグルマキク	アラバスターの花瓶
ヤグルマキク花瓶卓付	ヤグルマキク	アラバスターの花瓶	大理石のテーブル
ヤグルマキクつぼ付	ヤグルマキク	ペルシャ風のつぼ
ヤグルマキクつぼ卓付	ヤグルマキク	ペルシャ風のつぼ	大理石のテーブル
ヤグルマキク白つぼ付	ヤグルマキク	浮き彫りのつぼ
ヤグルマキク白つぼ卓付	ヤグルマキク	浮き彫りのつぼ	大理石のテーブル
クレロデンドルム	クレロデンドルム
クレロデンドルム卓付	クレロデンドルム	大理石のテーブル
クレロデンドルム花瓶付	クレロデンドルム	アラバスターの花瓶
クレロデンドルム花瓶卓付	クレロデンドルム	アラバスターの花瓶	大理石のテーブル
クレロデンドルムつぼ付	クレロデンドルム	ペルシャ風のつぼ
クレロデンドルムつぼ卓付	クレロデンドルム	ペルシャ風のつぼ	大理石のテーブル
クレロデンドルム白つぼ付	クレロデンドルム	浮き彫りのつぼ
クレロデンドルム白つぼ卓	クレロデンドルム	浮き彫りのつぼ	大理石のテーブル
アステリスカス	アステリスカス
アステリスカス卓付	アステリスカス	大理石のテーブル
アステリスカス花瓶付	アステリスカス	アラバスターの花瓶
アステリスカス花瓶卓付	アステリスカス	アラバスターの花瓶	大理石のテーブル
アステリスカスつぼ付	アステリスカス	ペルシャ風のつぼ
アステリスカスつぼ卓付	アステリスカス	ペルシャ風のつぼ	大理石のテーブル
アステリスカス白つぼ付	アステリスカス	浮き彫りのつぼ
アステリスカス白つぼ卓付	アステリスカス	浮き彫りのつぼ	大理石のテーブル
トケイソウ	トケイソウ
トケイソウ卓付	トケイソウ	大理石のテーブル
トケイソウ花瓶付	トケイソウ	アラバスターの花瓶
トケイソウ花瓶卓付	トケイソウ	アラバスターの花瓶	大理石のテーブル
トケイソウつぼ付	トケイソウ	ペルシャ風のつぼ
トケイソウつぼ卓付	トケイソウ	ペルシャ風のつぼ	大理石のテーブル
トケイソウ白つぼ付	トケイソウ	浮き彫りのつぼ
トケイソウ白つぼ卓付	トケイソウ	浮き彫りのつぼ	大理石のテーブル
トレニア	トレニア
トレニア卓付	トレニア	大理石のテーブル
トレニア花瓶付	トレニア	アラバスターの花瓶
トレニア花瓶卓付	トレニア	アラバスターの花瓶	大理石のテーブル
トレニアつぼ付	トレニア	ペルシャ風のつぼ
トレニアつぼ卓付	トレニア	ペルシャ風のつぼ	大理石のテーブル
トレニア白つぼ付	トレニア	浮き彫りのつぼ
トレニア白つぼ卓付	トレニア	浮き彫りのつぼ	大理石のテーブル
ヒガンバナ	ヒガンバナ
ムクゲ	ムクゲ
タカサゴユリ	タカサゴユリ
シマトネリコ	シマトネリコ
ウンナンサクラソウ	ウンナンサクラソウ
キング・プロテア	キング・プロテア
ハス	ハス

## http://world.xsrv.jp/dol/ より拝借 ----------------------------------------------------------------------
ペルシアンイエロー	ロサ・フェティダ・ペルシアーナ

